111111111111111
1P0C000C0011111
1000C000001E111
100C00000000011
10000C0000A0011
10000C000000011
1110C000C100111
1110C110C000011
1110C000C110011
1110C1C00010011
111111111111111